WWWWWWWWWWWWWWWWWWWWWWWWWWWWWWWWWWWWWWWWWWWWWWWWWWWWWWWWWWWWW
WGPGPGPGPGBGPGPGPGPGBGPGPGPGPGBGPGPGPGPGBGPGPGPGPGBGPGPGPGPW
WGPGPGPGPGPGPGPGPGPGPGPGPGPGPGPGPGPGPGPGPGPGPGPGPGPGPGPGPGPW
WGBGPGPGPGBGPGPGPGPGBGPGPGPGPGBGPGPGPGPGBGPGPGPGPGBGPGPGPGPW
WGBGPGPGPGBGPGPGPGPGBGPGPGPGPGBGPGPGPGPGBGPGPGPGPGBGPGPGPGPW
WGBGPGPGPGBGPGPGPGPGBGPGPGPGPGBGPGPGPGPGBGPGPGPGPGBGPGPGPGPW
WPPPPPPPPPPPPPPPPPPPPPPPPPPPPPPPPPPPPPPPPPPPPPPPPPPPPPPPPPPPW
WGPGBGPGPGPGPGBGPGPGPGPGBGPGPGPGPGBGPGPGPGPGBGPGPGPGPGBGPGPW
WGPGBGPGPGPGPGBGPGPGPGPGBGPGPGPGPGBGPGPGPGPGBGPGPGPGPGBGPGPW
WGPGBGPGPGPGPGBGPGPGPGPGBGPGPGPGPGBGPGPGPGPGBGPGPGPGPGBGPGPW
WGPGBGPGPGPGPGBGPGPGPGPGBGPGPGPGPGBGPGPGPGPGBGPGPGPGPGBGPGPW
WPPPPPPPPPPPPPPPPPPPPPPPPPPPPPPPPPPPPPPPPPPPPPPPPPPPPPPPPPPPW
WGPGPGPGPGBGPGPGPGPGBGPGPGPGPGBGPGPGPGPGBGPGPGPGPGBGPGPGPGPW
WGPGPGPGPGBGPGPGPGPGBGPGPGPGPGBGPGPGPGPGBGPGPGPGPGBGPGPGPGPW
WGPGPGPGPGBGPGPGPGPGBGPGPGPGPGBGPGPGPGPGBGPGPGPGPGBGPGPGPGPW
WGPGPGPGPGBGPGPGPGPGBGPGPGPGPGBGPGPGPGPGBGPGPGPGPGBGPGPGPGPW
WGPGPGPGPGBGPGPGPGPGBGPGPGPGPGBGPGPGPGPGBGPGPGPGPGBGPGPGPGPW
WPPPPPPPPPPPPPPPPPPPPPPPPPPPPPPPPPPPPPPPPPPPPPPPPPPPPPPPPPPPW
WGPGBGPGPGPGPGBGPGPGPGPGBGPGPGPGPGBGPGPGPGPGBGPGPGPGPGBGPGPW
WGPGBGPGPGPGPGBGPGPGPGPGBGPGPGPGPGBGPGPGPGPGBGPGPGPGPGBGPGPW
WGPGBGPGPGPGPGBGPGPGPGPGBGPGPGPGPGBGPGPGPGPGBGPGPGPGPGBGPGPW
WGPGBGPGPGPGPGBGPGPGPGPGBGPGPGPGPGBGPGPGPGPGBGPGPGPGPGBGPGPW
WPPPPPPPPPPPPPPPPPPPPPPPPPPPPPPPPPPPPPPPPPPPPPPPPPPPPPPPPPPPW
WGPGPGPGPGBGPGPGPGPGBGPGPGPGPGBGPGPGPGPGBGPGPGPGPGBGPGPGPGPW
WGPGPGPGPGBGPGPGPGPGBGPGPGPGPGBGPGPGPGPGBGPGPGPGPGBGPGPGPGPW
WGPGPGPGPGBGPGPGPGPGBGPGPGPGPGBGPGPGPGPGBGPGPGPGPGBGPGPGPGPW
WGPGPGPGPGBGPGPGPGPGBGPGPGPGPGBGPGPGPGPGBGPGPGPGPGBGPGPGPGPW
WGPGPGPGPGBGPGPGPGPGBGPGPGPGPGBGPGPGPGPGBGPGPGPGPGBGPGPGPGPW
WPPPPPPPPPPPPPPPPPPPPPPPPPPPPPPPPPPPPPPPPPPPPPPPPPPPPPPPPPPPW
WGPGBGPGPGPGPGBGPGPGPGPGBGPGPGPGPGBGPGPGPGPGBGPGPGPGPGBGPGPW
WGPGBGPGPGPGPGBGPGPGPGPGBGPGPGPGPGBGPGPGPGPGBGPGPGPGPGBGPGPW
WGPGBGPGPGPGPGBGPGPGPGPGBGPGPGPGPGBGPGPGPGPGBGPGPGPGPGBGPGPW
WGPGBGPGPGPGPGBGPGPGPGPGBGPGPGPGPGBGPGPGPGPGBGPGPGPGPGBGPGPW
WPPPPPPPPPPPPPPPPPPPPPPPPPPPPPPPPPPPPPPPPPPPPPPPPPPPPPPPPPPPW
WGPGPGPGPGBGPGPGPGPGBGPGPGPGPGBGPGPGPGPGBGPGPGPGPGBGPGPGPGPW
WGPGPGPGPGBGPGPGPGPGBGPGPGPGPGBGPGPGPGPGBGPGPGPGPGBGPGPGPGPW
WGPGPGPGPGBGPGPGPGPGBGPGPGPGPGBGPGPGPGPGBGPGPGPGPGBGPGPGPGPW
WWWWWWWWWWWWWWWWWWWWWWWWWWWWWWWWWWWWWWWWWWWWWWWWWWWWWWWWWWWWW
