WWWWWWWWWWWWWWWWWWWWWWWWWWWWWWWWWWWWWWWWWWWWWWWWWWWWWWWWWWWWW
WDDDDDDDDDWDDDDDDDDDDDDDDDDWDDDDDDDDDDDDDDDDDDDDWDDDDDDDDDW
WDDDDDDDDDWDDDDDDDDDDDDDDDDWDDDDDDDDDDDDDDDDDDDDWDDDDDDDDDW
WDDDDDDDDDWDDDDDDDDDDDDDDDDWDDDDDDDDDDDDDDDDDDDDWDDDDDDDDDW
WDDDDDDDDDWDDDDDDDDDDDDDDDDWDDDDDDDDDDDDDDDDDDDDWDDDDDDDDDW
WDDDDDDDDDWDDDDDDDDDDDDDDDDWDDDDDDDDDDDDDDDDDDDDWDDDDDDDDDW
WDDDDDDDDDWDDDDDDDDDDDDDDDDDDDDDDDDDDDDDDDDDDDDDDDDDDDDDDDDW
WDDDDDDDDDWDDDDDDDDDDDDDDDDDDDDDDDDDDDDDDDDDDDDDDDDDDDDDDDDW
WDDDDDDDDDWDDDDDDDDDDDDDDDDDDDDDDDDDDDDDDDDDDDDDDDDDDDDDDDDW
WDDDDDDDDDWDDDDDDDDDDDDDDDDWDDDDDDDDDDDDDDDDDDDDWDDDDDDDDDW
WDDDDDDDDDWDDDDDDDDDDDDDDDDWDDDDDDDDDDDDDDDDDDDDWDDDDDDDDDW
WDDDDDDDDDWDDDDDDDDDDDDDDDDWDDDDDDDDDDDDDDDDDDDDWDDDDDDDDDW
WDDDDDDDDDWDDDDDDDDDDDDDDDDWDDDDDDDDDDDDDDDDDDDDWDDDDDDDDDW
WDDDDDDDDDDDDDDDDDDDDDDDDDDWDDDDDDDDDDDDDDDDDDDDWDDDDDDDDDW
WDDDDDDDDDDDDDDDDDDDDDDDDDDWDDDDDDDDDDDDDDDDDDDDWDDDDDDDDDW
WDDDDDDDDDDDDDDDDDDDDDDDDDDWDDDDDDDDDDDDDDDDDDDDWDDDDDDDDDW
WDDDDDDDDDDDDDDDDDDDDDDDDDDWDDDDDDDDDDDDDDDDDDDDWDDDDDDDDDW
WDDDDDDDDDWDDDDDDDDDDDDDDDDWDDDDDDDDDDDDDDDDDDDDWDDDDDDDDDW
WDDDDDDDDDWDDDDDDDDDDDDDDDDWDDDDDDDDDDDDDDDDDDDDWDDDDDDDDDW
WDDDDDDDDDWDDDDDDDDDDDDDDDDWDDDDDDDDDDDDDDDDDDDDWDDDDDDDDDW
WWWWWWWWWWWWWWDDDWWWWWWWWWWWWWWWWWDDDWWWWWWWWWWWWWWWWWWWWWW
WDDDDDDDDDWDDDDDDDDDDDDDDDDWDDDDDDDDDDDDDDDDDDDDWDDDDDDDDDW
WDDDDDDDDDWDDDDDDDDDDDDDDDDWDDDDDDDDDDDDDDDDDDDDWDDDDDDDDDW
WDDDDDDDDDWDDDDDDDDDDDDDDDDWDDDDDDDDDDDDDDDDDDDDWDDDDDDDDDW
WDDDDDDDDDWDDDDDDDDDDDDDDDDWDDDDDDDDDDDDDDDDDDDDWDDDDDDDDDW
WDDDDDDDDDWDDDDDDDDDDDDDDDDWDDDDDDDDDDDDDDDDDDDDWDDDDDDDDDW
WDDDDDDDDDDDDDDDDDDDDDDDDDDWDDDDDDDDDWDDDDDDDDDDDDDDDDDDDDW
WDDDDDDDDDDDDDDDDDDDDDDDDDDWDDDDDDDDDWDDDDDDDDDDDDDDDDDDDDW
WDDDDDDDDDDDDDDDDDDDDDDDDDDWDDDDDDDDDWDDDDDDDDDDDDDDDDDDDDW
WDDDDDDDDDWDDDDDDDDDDDDDDDDWDDDDDDDDDWDDDDDWWWWWWDDDDDDDDDW
WDDDDDDDDDWDDDDDDDDDDDDDDDDWDDDDDDDDDWDDDDDWDDDDDDDDDDDDDW
WDDDDDDDDDWDDDDDDDDDDDDDDDDWDDDDDDDDDWDDDDDWDDDDDDDDDDDDDW
WDDDDDDDDDWDDDDDDDDDDDDDDDDWDDDDDDDDDWDDDDDWDDDDDDDDDDDDDW
WDDDDDDDDDWDDDDDDDDDDDDDDDDWDDDDDDDDDWDDDDDWDDDDDDDDDDDDDW
WDDDDDDDDDWDDDDDDDDDDDDDDDDWDDDDDDDDDWDDDDDWDDDDDDDDDDDDDW
WDDDDDDDDDWDDDDDDDDDDDDDDDDWDDDDDDDDDWDDDDDWDDDDDDDDDDDDDW
WDDDDDDDDDWDDDDDDDDDDDDDDDDWDDDDDDDDDDDDDDDDDDDDWDDDDDDDDDW
WDDDDDDDDDWDDDDDDDDDDDDDDDDWDDDDDDDDDDDDDDDDDDDDWDDDDDDDDDW
WDDDDDDDDDWDDDDDDDDDDDDDDDDWDDDDDDDDDDDDDDDDDDDDWDDDDDDDDDW
WWWWWWWWWWWWWWWWWWWWWWWWWWWWWWWWWWWWWWWWWWWWWWWWWWWWWWWWWWWWW
