WWWWWWWWWWWWWWWWWWWWWWWWWWWWWWWWWWWWWWWWWWWWWWWWWWWWWWWWWWWWW
WGGGGGTGGGGGGGGTGGGGGGGGGGGGGGGGGGGGTGGGGGGGGGGGGTGGGGGGGGW
WGGGTGGGGTGGGGGGGGGGGGGTGGGGGGGGGTGGGGGGGGGGGGGGGGGGGGGGGGW
WGGGGGGGGGGGGGGGGGGGGGGGGGGGGGGGGGGGGGGTGGGGGGGGGGGGGGGGGGW
WGGGGGGGGGGGGGGGGGGGGGGGGGGGGTGGGGGGGGGGGGGGGGGGGGGGGGGGGGW
WGGGGGGGGTGGGGGGGGGGGGGGGGGGGGGGGGGGGGTGGGGGGGGGGGGGGGTGGGW
WGGGGGGGGGGGGTGGGGGGTGGGGGGGGGGGGGGGGGGGGGGGGGGGGGGGGGGGGGW
WGGGGGGGGGGGGGGGGGGGGGGGGGGGGGGGGGTGGGGGGGGGGGGGGGGGGGGGGGW
WGGTGGGGGGGGGGGGGGGGGTGGGGGGGGGGGGGGGGGGGGGGGGGGTGGGGGGGGGW
WGGGGGGGGTGGGGGGGGGGGGGGGGGGGGGGGGGGGGGGGGGGGGGGGGGGGGGGTGW
WGGGGGGGGGGGGGGGGGGGGGGGGGGTGGGGGGGGGGGGGGGGGGGGGGGGGGGGGGW
WGGGGGGGGGGGGGGTGGGGGGGGGGGGGGGTGGGGGGGGGGGGGGGGGGTGGGGGGGW
WGGGGGTGGGGGGGGGGGGGGGGGGGGGGGGGGGGGGGGGGGGGGTGGGGGGGGGGGGW
WPPPPPPPPPGGGGGGGGGGGGGGGGGGGGGGGPPPPPPPPPPPGGGGGGGGGGGGGGW
WGGGGGGGPPGGGGGGGGTGGGGGGGGGGGGTGPGGGGGGGGGPGGGGGGGGGGGGGGW
WGGGGGGGPGGGGTGGGGGGGGGGGGGGGGGGPGGGGTGGGGGPGGTGGGGGGGGGGPW
WGGGGGTGPGGGGGGGGGGGGTGGGGGTGGGGPGGGGGGGGGGPGGGGGGGGGGGGGPW
WGGGGGGGPGGGGGGGGGGGGGGGGGGGGGGGPGGGGGGGGGGPGGGTGGGGGGTGGPW
WGGGGGGPPGGGGGGTGGGGGGGGTGGGGGGPPGGGGGGGGGGPGGGGGGGGGGGGGPW
WGGGGGGGGGGGGGGGGGGGGGGGGGGGGGGGPGGGTGGGGGGPGGGGGGTGGGGGGGW
WGGGGGGGGGGGGGGGGGGGGGTGGGGGGGTGPGGGGGGGGGGPGGGGGGGGGGGGGPW
WGGGTGGGGGGTGGGGGGGGGGGGGGTGGGGGPGGGGGGGGGGPGGGGGGGGTGGGGPW
WGGGGGGGGGGGGGGGGGGGGGGGGGGGGGGPPGGGGGTGGGGPGGGTGGGGGGGGGPW
WGGGGGGGGGGGGGGGGGGGTGGGGGGGGGGGPGGGGGGGGGGPGGGGGGGGGGGGGPW
WGGGGTGGGGGGGGGGGGGGGGGGGGGGGGTGPGGGGTGGGGGPGGGGGGGGGGTGGGW
WGGGGGGGGGGGGGGGGGTGGGGGGGGGGGGPPGGGGGGGGGPPGGGGGTGGGGGGGPW
WGGGGGGGGGGGGGGGGGGGGGGGGGGGTGGGPGGGGGGGGGGPGGGGGGGGGGGGGPW
WGGGGGGGGGGGGGGGGGGGGGGGGGGGGGGGPGGGGGTGGGGPGGGGGGGGGGGGGPW
WGTGGGGGGGGGGTGGGGGGGGGTGGGGGGGGPGGGGGGGGGGPGGGGGTGGGGGGGPW
WGGGGGGGGGGGGGGGGGGGGGGGGGGGGGGPPGGGGGGGTGGPGGGGGGGGGGGGGGW
WGGGGGGTGGGGGGGGGGGGGGGGGGGGGGGGPGGTGGGGGGGPGGGGGGGGGGGGTPW
WGGGGGGGGGGGGGGGGTGGGGGGTGGGGGGGGGGGGGGGGGGPGGGGTGGGGGGGGGW
WGGGGGGGGGGGGGGGGGGGGGGGGGGGGGGGGGGGGGGGTGGGGGGGGGGGGGGGGGW
WGGGGGGGTGGGGGGTGGGGGGGGGGGGGGTGGGGGGGGGGGGGGGTGGGGGGGGTGGW
WGGGGGGGGGGGGGGGGGGGGGGGGGGGGGGGGGGGGGGGGGGGGGGGGGGGTGGGGGW
WGGGGTGGGGGGGGGGGGGGGTGGGGGGGGGGGGGGGGGGGGTGGGGGGGGGGGGGGGW
WGGGGGGGGGGGGGGGGGGGGGGGTGGGGGGTGGGGGGGGTGGGGGGGGGGGGGGGGGW
WGTGGGGGGGGGGGTGGGGGGGGGGGGGGGGGGGGGGGGGGGGGGGGGGGGTGGGGTGW
WWWWWWWWWWWWWWWWWWWWWWWWWWWWWWWWWWWWWWWWWWWWWWWWWWWWWWWWWWWWW
