WWWWWWWWWWWWWWWWWWWWWWWWWWWWWWWWWWWWWWWWWWWWWWWWWWWWWWWWWWWWW
WGGGGGGGGTGGGGGGGGGGGTGGGGGGGGGGTTGGGGGGTGGGGGGTGGGGGGGGGTW
WGGGGGGTGGGGGGGGGGGGTGGGGGGGGGTGGGGGGGGGGGGGGGGGGGGGGTGGGGW
WGGGGGGGGGGGGGGTGGGGGGGGGGGGGGGGGGGGGGGGGGGGGGGGGGGGGGGGGGW
WGGGGGGGGGGGGGGGGGGGGGGGGGGGGGGTGGGGGGGGGTTGGGGGGGGGGGGGTGW
WGGTGTGGGGGGGGGTGGGGTGGGGGGTGGGGGGGGGGGGGTTGGGGGGGGGTGGGGGW
WGGGGGGGGTGGGGGGGGGGGGGTGGGGGGGGGGGTGGGGGGTGGGGGGTGGGGGGTGW
WTTTGGGGGGGGGGGGGGGGGGGGGGGGGGGGGGGGGGGGGGGGGGGGGGGGGGGGTGW
WGTTTGGGGGGGGGGTGGGGGGGGGGGTGGGGGGGGGGGGTTGGGGTGGGGGGGGGTGW
WGGTTTGGGGGGGGGGGGGGGGTGGGGGGGGGGTGGGGGTGTTTGGGGGGGGGGTGGGW
WGGGTTGGGTGGGGGGGGGGGGGGGGGGGGGGGGGGGGGGGTTGGGGGGGGGGGGGGGW
WGGGGTTGGGGGGGGGGGGGTGGGGGGGGGGGTTGGGGGGGGTGGGGGGGGGGGGGTGW
WGGGGTTTGGGGGGGGGGGGGGGGGGGTGGGTTTGGGGGGGGGGGGGGTGGGGGGGGGW
WGGGGTTTTTTGGGGGGGTGGGGGGGGGGGGGTTTTTTTGGGGGGGGGGGGGGGGGGGW
WGGGGGGGTTTTGGGGGGGGGGGGGGGGGGGGGGGTTTTTTGGGGTGGGGGGGTGGGGW
WGGGGGGGTTTTTGTGGGGGGGTGGGGTGGGGGGGGGTTTTGGGGGGGGGGGGGGGGGW
WGGGGGGGGGTTTTGGGGGGGGGGGGGGGGGGGGGGGTTTTGGGGGGGGGGGGGGGGGW
WGGGGGGTGGTTTTGGGGGGGGGGGGGGGGGGGGGGGGTTTTGGGGGGGGGGGGGGTGW
WGGGGGGGGTTTTTGGGGGGGGGGGGGGGGGGGGGGGGTTTTGTGGGGGTGGGGGGGGW
WGGGGGGGGGTTTTGGGGGGGGGGGGGGGGTGGGGGGGTTTTTGGGGGGGGGGGGGGGW
WGGGGGGGGGTTTGGGGGTGGGGGGGGGGGGGGGGGGGTTTTTGGGGTGGGGGGGGTGW
WGGGGGGGGGGTTGGGGGGGGGGGTGGGGGGGGGGTGGGTTTTGGGGGGGGGGGGGTGW
WGGGGGGGTTTTTTGGGGGGGGGGGGGGGGGGGGGGGGTTTTTGGGGGGGGGGGGGGGW
WGGGGGTGTTGGTTGGGGGGGGGGGGGGGGGGTGGGGGTTTTGGGGGGGTGGGGGGTGW
WGGGGTTTTTGGTTTGGGGGGTGGGGGGGGGGGGGGGTTTTGGGGGGGGGGGGGGGGGW
WGGGTTTTTGGGTTTGGGGGGGGGGGGGGGGGGGGGTTTTGGGGGGGGGGGGGGGGTGW
WGGGGTTTTGGTTTTGGGGGGGGTGGGGGGGGGGGGTTTTGGGGGGGGTGGGGGGGGGW
WGGGGGTTTTTTTTGGGGGGGGGGGGGGGGTGGGTTTTTTTGGGGGGGGGGGGGGGTGW
WGGGGGGGTTTTTTGGGGGGGGGGGGGGGGGGGTTTTTTGGGGGGTGGGGGGGGGGGGW
WGTGGGGGGGTTGGGGGGGTGGGGGTGGGGGTTTTTTTGGGGGGGGGGGGGGGGGGTGW
WGGGGGGTGGTTGGGGGGGGGGGGGGGGGTTTTTTTGGGGGGGGGGGGGGGGTGGGGGW
WGGGGGGGGGTTGGGGGGGGGGGGGGTTTTTTTTTGGGGGGGGGGTGGGGGGGGGGTGW
WGGGGGGGGTTGGGGGTGGGGGGGTTTTTTTTTGGGGGGGGGGGGGGGGGGTGGGGGWW
WGGGTGGGGGTTGGGGGGGGGTTTTTTTTTGGGGGTGGGGGGGGGGGGGGGGGGGGGGW
WGGGGGGGGGTTTGTTTTTTTTTTTTTGGGGGGGGGGGGGGGGGTGGGGGGGGGGGTGW
WGGGGGGGGGTTTTTTTTTTTTTTTGGGGGGGGGGGGGGGGGTGGGGGGGGGGGTGTGW
WGGGGGGGGGGTTTGGGGTTTTTGGGGGGGTGGGGGGGGGGGGGGGGGGGGGGGGGGGG
WGGGGGTGGGGGGGGGGGGGGGGGGGGGGGGGGGGGGGGGGGGGGGTGGGGGGGGGGGG
WGGGGGGGGGGTGGGGGGGTGGGGGGGGTGGGGGGGTGGGGGGGGGGGGGGGTGGGGTW
WWWWWWWWWWWWWWWWWWWWWWWWWWWWWWWWWWWWWWWWWWWWWWWWWWWWWWWWWWWWW
