{
  "name": "🌲 Bosque Oscuro",
  "description": "Bosque denso habitado por criaturas peligrosas",
  "type": "forest",
  "safeZone": false,
  "worldPosition": { "x": 300, "y": 220 },
  "layout": [
    [4,4,4,4,4,4,4,4,4,4,4,4,4,4,4,4,4,4,4,4,4,4,4,4,4,4,4,4,4,4,4,4,4,4,4,4,4,4,4,4,4,4,4,4,4,4,4,4,4,4],
    [4,0,3,0,0,3,0,0,0,3,0,0,3,0,0,0,3,0,3,0,0,0,3,0,0,3,0,0,0,3,0,0,3,0,0,0,3,0,3,0,0,3,0,0,0,3,0,0,3,4],
    [4,0,0,3,0,0,0,3,0,0,3,0,0,0,3,0,0,3,0,0,3,0,0,0,3,0,0,3,0,0,3,0,0,0,3,0,0,3,0,0,3,0,0,3,0,0,0,3,0,4],
    [4,3,0,0,3,0,3,0,0,0,0,3,0,3,0,0,0,0,3,0,0,3,0,3,0,0,0,0,3,0,0,3,0,3,0,0,0,0,3,0,0,0,3,0,3,0,0,0,0,4],
    [4,0,3,0,0,3,0,0,3,0,3,0,0,0,3,0,3,0,0,3,0,0,3,0,0,3,0,3,0,0,0,3,0,0,3,0,3,0,0,3,0,3,0,0,0,3,0,3,0,4],
    [4,0,0,3,0,0,0,3,0,0,3,0,0,3,0,0,0,3,0,0,3,0,0,0,3,0,0,3,0,0,3,0,0,3,0,0,0,3,0,0,3,0,0,3,0,0,3,0,0,4],
    [4,3,0,0,3,0,3,0,0,0,0,3,0,0,3,0,3,0,0,0,0,3,0,3,0,0,0,0,3,0,0,3,0,0,3,0,3,0,0,0,0,3,0,0,3,0,0,0,3,4],
    [4,0,3,0,0,3,0,0,3,0,3,0,0,3,0,0,0,3,0,3,0,0,3,0,0,3,0,3,0,0,0,3,0,3,0,0,0,3,0,3,0,0,3,0,0,3,0,3,0,4],
    [4,0,0,3,0,0,0,3,0,0,3,0,0,0,3,0,3,0,0,3,0,0,0,3,0,0,3,0,0,3,0,0,3,0,0,3,0,0,3,0,0,3,0,0,0,3,0,0,3,4],
    [4,3,0,0,3,0,3,0,0,0,0,3,0,3,0,0,0,3,0,0,3,0,3,0,0,0,0,3,0,0,3,0,0,3,0,0,3,0,0,3,0,0,3,0,3,0,0,0,0,4],
    [4,0,3,0,0,3,0,0,3,0,3,0,0,3,0,0,3,0,0,3,0,0,3,0,0,3,0,3,0,0,0,3,0,3,0,0,0,3,0,3,0,0,3,0,0,3,0,3,0,4],
    [4,0,0,3,0,0,0,3,0,0,3,0,0,0,3,0,0,3,0,0,3,0,0,0,3,0,0,3,0,0,3,0,0,3,0,0,3,0,0,3,0,0,3,0,0,3,0,0,3,4],
    [4,3,0,0,3,0,3,0,0,0,0,3,0,3,0,0,3,0,0,0,0,3,0,3,0,0,0,0,3,0,0,3,0,0,3,0,0,3,0,0,3,0,0,3,0,0,0,3,0,4],
    [4,0,3,0,0,3,0,0,3,0,3,0,0,3,0,0,0,3,0,3,0,0,3,0,0,3,0,3,0,0,0,3,0,3,0,0,3,0,0,3,0,0,3,0,0,3,0,3,0,4],
    [4,0,0,3,0,0,0,3,0,0,3,0,0,0,3,0,3,0,0,3,0,0,0,3,0,0,3,0,0,3,0,0,3,0,0,3,0,0,3,0,0,3,0,0,0,3,0,0,3,4],
    [4,3,0,0,3,0,3,0,0,0,0,3,0,3,0,0,0,3,0,0,3,0,3,0,0,0,0,3,0,0,3,0,0,3,0,0,3,0,0,3,0,0,3,0,3,0,0,0,0,4],
    [4,0,3,0,0,3,0,0,3,0,3,0,0,3,0,0,3,0,0,3,0,0,3,0,0,3,0,3,0,0,0,3,0,3,0,0,0,3,0,3,0,0,3,0,0,3,0,3,0,4],
    [4,0,0,3,0,0,0,3,0,0,3,0,0,0,3,0,0,3,0,0,3,0,0,0,3,0,0,3,0,0,3,0,0,3,0,0,3,0,0,3,0,0,3,0,0,3,0,0,3,4],
    [4,3,0,0,3,0,3,0,0,0,0,3,0,3,0,0,3,0,0,0,0,3,0,3,0,0,0,0,3,0,0,3,0,0,3,0,0,3,0,0,3,0,0,3,0,0,0,3,0,4],
    [4,0,3,0,0,3,0,0,3,0,3,0,0,3,0,0,0,3,0,3,0,0,3,0,0,3,0,3,0,0,0,3,0,3,0,0,3,0,0,3,0,0,3,0,0,3,0,3,0,4],
    [4,0,0,3,0,0,0,3,0,0,3,0,0,0,3,0,3,0,0,3,0,0,0,3,0,0,3,0,0,3,0,0,3,0,0,3,0,0,3,0,0,3,0,0,0,3,0,0,3,4],
    [4,3,0,0,3,0,3,0,0,0,0,3,0,3,0,0,0,3,0,0,3,0,3,0,0,0,0,3,0,0,3,0,0,3,0,0,3,0,0,3,0,0,3,0,3,0,0,0,0,4],
    [4,0,3,0,0,3,0,0,3,0,3,0,0,3,0,0,3,0,0,3,0,0,3,0,0,3,0,3,0,0,0,3,0,3,0,0,0,3,0,3,0,0,3,0,0,3,0,3,0,4],
    [4,0,0,3,0,0,0,3,0,0,3,0,0,0,3,0,0,3,0,0,3,0,0,0,3,0,0,3,0,0,3,0,0,3,0,0,3,0,0,3,0,0,3,0,0,3,0,0,3,4],
    [4,3,0,0,3,0,3,0,0,0,0,3,0,3,0,0,3,0,0,0,0,3,0,3,0,0,0,0,3,0,0,3,0,0,3,0,0,3,0,0,3,0,0,3,0,0,0,3,0,4],
    [4,0,3,0,0,3,0,0,3,0,3,0,0,3,0,0,0,3,0,3,0,0,3,0,0,3,0,3,0,0,0,3,0,3,0,0,3,0,0,3,0,0,3,0,0,3,0,3,0,4],
    [4,0,0,3,0,0,0,3,0,0,3,0,0,0,3,0,3,0,0,3,0,0,0,3,0,0,3,0,0,3,0,0,3,0,0,3,0,0,3,0,0,3,0,0,0,3,0,0,3,4],
    [4,3,0,0,3,0,3,0,0,0,0,3,0,3,0,0,0,3,0,0,3,0,3,0,0,0,0,3,0,0,3,0,0,3,0,0,3,0,0,3,0,0,3,0,3,0,0,0,0,4],
    [4,0,3,0,0,3,0,0,3,0,3,0,0,3,0,0,3,0,0,3,0,0,3,0,0,3,0,3,0,0,0,3,0,3,0,0,0,3,0,3,0,0,3,0,0,3,0,3,0,4],
    [4,0,0,3,0,0,0,3,0,0,3,0,0,0,3,0,0,3,0,0,3,0,0,0,3,0,0,3,0,0,3,0,0,3,0,0,3,0,0,3,0,0,3,0,0,3,0,0,3,4],
    [4,3,0,0,3,0,3,0,0,0,0,3,0,3,0,0,3,0,0,0,0,3,0,3,0,0,0,0,3,0,0,3,0,0,3,0,0,3,0,0,3,0,0,3,0,0,0,3,0,4],
    [4,0,3,0,0,3,0,0,3,0,3,0,0,3,0,0,0,3,0,3,0,0,3,0,0,3,0,3,0,0,0,3,0,3,0,0,3,0,0,3,0,0,3,0,0,3,0,3,0,4],
    [4,0,0,3,0,0,0,3,0,0,3,0,0,0,3,0,3,0,0,3,0,0,0,3,0,0,3,0,0,3,0,0,3,0,0,3,0,0,3,0,0,3,0,0,0,3,0,0,3,4],
    [4,3,0,0,3,0,3,0,0,0,0,3,0,3,0,0,0,3,0,0,3,0,3,0,0,0,0,3,0,0,3,0,0,3,0,0,3,0,0,3,0,0,3,0,3,0,0,0,0,4],
    [4,0,3,0,0,3,0,0,3,0,3,0,0,3,0,0,3,0,0,3,0,0,3,0,0,3,0,3,0,0,0,3,0,3,0,0,0,3,0,3,0,0,3,0,0,3,0,3,0,4],
    [4,0,0,3,0,0,0,3,0,0,3,0,0,0,3,0,0,3,0,0,3,0,0,0,3,0,0,3,0,0,3,0,0,3,0,0,3,0,0,3,0,0,3,0,0,3,0,0,3,4],
    [4,3,0,0,3,0,3,0,0,0,0,3,0,3,0,0,3,0,0,0,0,3,0,3,0,0,0,0,3,0,0,3,0,0,3,0,0,3,0,0,3,0,0,3,0,0,0,3,0,4],
    [4,0,3,0,0,3,0,0,3,0,3,0,0,3,0,0,0,3,0,3,0,0,3,0,0,3,0,3,0,0,0,3,0,3,0,0,3,0,0,3,0,0,3,0,0,3,0,3,0,4],
    [4,0,0,3,0,0,0,3,0,0,3,0,0,0,3,0,3,0,0,3,0,0,0,3,0,0,3,0,0,3,0,0,3,0,0,3,0,0,3,0,0,3,0,0,0,3,0,0,3,4],
    [4,3,0,0,3,0,3,0,0,0,0,3,0,3,0,0,0,3,0,0,3,0,3,0,0,0,0,3,0,0,3,0,0,3,0,0,3,0,0,3,0,0,3,0,3,0,0,0,0,4],
    [4,0,3,0,0,3,0,0,3,0,3,0,0,3,0,0,3,0,0,3,0,0,3,0,0,3,0,3,0,0,0,3,0,3,0,0,0,3,0,3,0,0,3,0,0,3,0,3,0,4],
    [4,0,0,3,0,0,0,3,0,0,3,0,0,0,3,0,0,3,0,0,3,0,0,0,3,0,0,3,0,0,3,0,0,3,0,0,3,0,0,3,0,0,3,0,0,3,0,0,3,4],
    [4,3,0,0,3,0,3,0,0,0,0,3,0,3,0,0,3,0,0,0,0,3,0,3,0,0,0,0,3,0,0,3,0,0,3,0,0,3,0,0,3,0,0,3,0,0,0,3,0,4],
    [4,0,3,0,0,3,0,0,3,0,3,0,0,3,0,0,0,3,0,3,0,0,3,0,0,3,0,3,0,0,0,3,0,3,0,0,3,0,0,3,0,0,3,0,0,3,0,3,0,4],
    [4,0,0,3,0,0,0,3,0,0,3,0,0,0,3,0,3,0,0,3,0,0,0,3,0,0,3,0,0,3,0,0,3,0,0,3,0,0,3,0,0,3,0,0,0,3,0,0,3,4],
    [4,3,0,0,3,0,3,0,0,0,0,3,0,3,0,0,0,3,0,0,3,0,3,0,0,0,0,3,0,0,3,0,0,3,0,0,3,0,0,3,0,0,3,0,3,0,0,0,0,4],
    [4,0,3,0,0,3,0,0,3,0,3,0,0,3,0,0,3,0,0,3,0,0,3,0,0,3,0,3,0,0,0,3,0,3,0,0,0,3,0,3,0,0,3,0,0,3,0,3,0,4],
    [4,0,0,3,0,0,0,3,0,0,3,0,0,0,3,0,0,3,0,0,3,0,0,0,3,0,0,3,0,0,3,0,0,3,0,0,3,0,0,3,0,0,3,0,0,3,0,0,3,4],
    [4,3,0,0,3,0,3,0,0,0,0,3,0,3,0,0,3,0,0,0,0,3,0,3,0,0,0,0,3,0,0,3,0,0,3,0,0,3,0,0,3,0,0,3,0,0,0,3,0,4],
    [4,0,3,0,0,3,0,0,3,0,3,0,0,3,0,0,0,3,0,3,0,0,3,0,0,3,0,3,0,0,0,3,0,3,0,0,3,0,0,3,0,0,3,0,0,3,0,3,0,4],
    [4,0,0,3,0,0,0,3,0,0,3,0,0,0,3,0,3,0,0,3,0,0,0,3,0,0,3,0,0,3,0,0,3,0,0,3,0,0,3,0,0,3,0,0,0,3,0,0,3,4],
    [4,4,4,4,4,4,4,4,4,4,4,4,4,4,4,4,4,4,4,4,4,4,4,4,4,4,4,4,4,4,4,4,4,4,4,4,4,4,4,4,4,4,4,4,4,4,4,4,4,4]
  ],
  "npcs": [
    { "type": "hermit", "x": 25, "y": 25, "dialogue": "hermit_wisdom" }
  ],
  "enemies": {
    "enabled": true,
    "types": [
      { "type": "wolf", "count": 6, "minLevel": 3, "maxLevel": 5 },
      { "type": "spider", "count": 8, "minLevel": 2, "maxLevel": 4 },
      { "type": "goblin_warrior", "count": 4, "minLevel": 4, "maxLevel": 6 }
    ],
    "spawnAreas": "forest"
  },
  "objects": {
    "density": 0.06,
    "types": ["potion", "gold", "armor", "sword"],
    "spawnAreas": "ground"
  },
  "portals": [
    { "x": 5, "y": 20, "targetMap": "newbie_field", "targetX": 43, "targetY": 10, "name": "Campo" },
    { "x": 45, "y": 35, "targetMap": "ancient_ruins", "targetX": 5, "targetY": 5, "name": "Ruinas" }
  ],
  "connections": {}
}
